111111111111111111111111111
1E0000000000000C000V0C00001
10100101001000001010010V001
1010V1001010101V001001000V1
1P00000V0C00C00000000000001
111111111111111111111111111