1111111111111
10V10000000C1
1V000111110V1
1P0V11E0000C1
1111111111111